5
10
S-D-----D-
-----D----
-D-D------
-----D----
--J------D

