5
10
S--------J
--D---D---
--D----D--
----D-----
--D----D--
